TIME: 60

11111111111111111111
1SS01000000000010001
1SS01000000000010001
10C0100Q00V000010001
10000000111100000001
100H00CP00000C000001
11100000000000000111
1000C0000IX0000C0001
11100000000000000111
100000C000000B000001
10000000111100H00001
1000100Q000000010001
10001000000000010FF1
10001000000000010FF1
11111111111111111111
