TIME: 60

11111111111111111111
1SS00010000001000001
1SS00010000001000001
100C0010000001000001
1000H000000000000001
1000000P000000000001
11110000011000001111
10+00C000II000C00001
11110000011000001111
10000000000000000001
100000000000000H0001
100C001000000100R001
10000010000001000FF1
10000010000001000FF1
11111111111111111111
