TIME: 30

11111111111111111111
1SS00000000000000FF1
1SS00000000000000FF1
10000000000000000001
10000000H0G000000001
10000011100111000001
10000000000000000001
10000C0000C0000C0001
10000000000000000001
10000011100111000001
100000000000H0000001
10000000000000000001
10000000000000000001
10000000000000000001
11111111111111111111
